NO xpm/textures3/text00.xpm           
SO xpm/textures3/text01.xpm    
WE xpm/textures3/text02.xpm         
EA xpm/textures3/text03.xpm

F  122, 23, 254
C  10, 10, 10

111111111111111    11111111111111111111111111
111000D00000001    10000000000000000000D00001
100011111100101    10000000000000000000111101
10000000D100101    100000000000000000001  101
11111111011010111  100000000000000000001  101
100000D0W0D00000111100000000000000000001  101
1011111101111110000000000000000000000001  101
10001011D10001D0111110000000000000000001  101
10001D00000000011   10000000000000000001  101
1D111111111111111   1111111111111D111111  101
101                             101       101
101                             101       101
101                             101       101
101111111111111111111111111111111011111111101
100000000000000000000000000000000000000000001
1D1111111111111111111111111111111011111111111
101                             101
101111111111111    11111111111111011111111111
101000D00000001    10000000000000000000D00001
100011111100101    10000000000000000000111101
10000000D100101    100000000000000000001  101
11111111011010111  100000000000000000001  101
100000D000D00000111100000000000000000001  101
1011111101111110000000000000000000000001  101
1000000000000000000000000000000000000001  101
1000000110000011000001100000110000000001  101
1000000000000000000000000000000000000001  101
1000000110000011000001100000110000000001  101
1000000000000000000000000000000000000001  101
101111111111111111111111100000001011111111101
100000000000000000000000000000000000000000001
1111111111111111111111111111111111111111111111